#DungeonBackground
RENDERER BackGround2
POSITION 0 0 -2
ROTATION 0 0 0
SCALE 1 1 1

#GameObjects: 4
1. Dungeon
1 1 1 1 1 1 1 1 1 1 1 1 1 1 1 1
1 1 1 0 0 0 0 0 0 0 0 0 0 1 1 1
1 1 1 0 0 0 0 0 0 0 0 0 0 1 1 1
1 0 0 0 0 1 1 1 1 1 1 0 0 0 0 1
1 8 0 0 0 1 1 1 1 1 1 0 0 0 9 1
1 1 1 0 0 1 1 1 1 1 1 0 0 1 1 1
1 1 1 0 0 1 1 1 1 1 1 0 0 1 1 1
1 1 1 0 0 0 0 0 0 0 0 0 0 1 1 1
1 1 1 0 0 0 0 0 0 0 0 0 0 1 1 1
1 1 1 1 1 1 1 1 1 1 1 1 1 1 1 1

2. SawBlade
NUMBERBLADES 2
POSITION 5 7
POSITION 8 6

3. Guard
NUMBERGUARDS 1
POSITIONSTART 3 0
POSITIONEND 11 0

4. Star
NUMBERSTARS 3
POSITION 11 4
POSITION 8 7
POSITION 2 5