#DungeonBackground
RENDERER BackGround4
POSITION 0 0 -2
ROTATION 0 0 0
SCALE 1 1 1

#GameObjects: 3
1. Dungeon
1 1 1 1 1 1 1 1 1 1 1 1 1 1 1 1
1 0 0 1 1 1 1 0 9 0 0 0 0 0 0 1
1 8 0 1 1 1 1 0 0 0 0 0 0 0 0 1
1 0 0 0 0 1 1 1 1 1 1 1 1 0 0 1
1 0 0 0 0 1 1 1 1 1 1 1 1 0 0 1
1 1 1 0 0 0 0 0 0 1 1 0 0 0 0 1
1 1 1 0 0 0 0 0 0 1 1 0 0 0 0 1
1 1 1 1 1 1 1 0 0 0 0 0 0 1 1 1
1 1 1 1 1 1 1 0 0 0 0 0 0 1 1 1
1 1 1 1 1 1 1 1 1 1 1 1 1 1 1 1

2. Guard
NUMBERGUARDS 2
POSITIONSTART 6 6
POSITIONEND 11 6
POSITIONSTART 6 0
POSITIONEND 11 0

3. Star
NUMBERSTARS 3
POSITION 13 5
POSITION 10 2
POSITION 3 4