#DungeonBackground
RENDERER BackGround3
POSITION 0 0 -2
ROTATION 0 0 0
SCALE 1 1 1

#GameObjects: 3
1. Dungeon
1 1 1 1 1 1 1 1 1 1 1 1 1 1 1 1
1 0 0 0 0 0 0 0 0 0 0 0 0 0 0 1
1 0 0 0 0 0 0 0 0 0 0 0 0 0 0 1
1 0 0 0 0 0 0 0 0 0 0 1 1 0 0 1
1 0 0 0 0 0 0 8 0 0 0 1 1 0 0 1
1 0 0 0 0 0 0 1 1 0 0 0 0 0 0 1
1 9 0 0 0 0 0 1 1 0 0 0 0 0 0 1
1 1 1 1 1 0 0 0 0 0 0 1 1 1 1 1
1 1 1 1 1 0 0 0 0 0 0 1 1 1 1 1
1 1 1 1 1 1 1 1 1 1 1 1 1 1 1 1

2. SawBlade
NUMBERBLADES 2
POSITION 7 0
POSITION 9 6

3. Star
NUMBERSTARS 3
POSITION 9 3
POSITION 9 7
POSITION 7 1



