#Objects: 3
1. DungeonBackground
RENDERER DungeonBackground
POSITION 0 0 -2
ROTATION 0 0 0
SCALE 1 1 1

2. Dungeon
1 1 1 1 1 1 1 1 1 1 1 1 1 1 1 1
1 0 1 1 0 1 1 0 0 0 0 0 0 0 0 1
1 0 1 1 0 1 1 0 0 0 0 0 0 0 0 1
1 0 0 0 0 1 1 0 0 1 1 0 0 0 0 1
1 0 1 1 0 1 1 0 0 1 1 0 0 0 8 1
1 0 1 1 0 1 1 0 0 0 0 0 0 1 1 1
1 0 1 1 0 1 1 0 0 0 0 0 0 1 1 1
1 0 1 1 0 0 0 0 0 1 1 0 0 0 0 1
1 9 1 1 0 1 1 1 1 1 1 1 1 1 1 1
1 1 1 1 1 1 1 1 1 1 1 1 1 1 1 1

3. SawBlade
NUMBERBLADES 1
POSITION 5 5



