#DungeonBackground
RENDERER DungeonBackground
POSITION 0 0 -2
ROTATION 0 0 0
SCALE 1 1 1

#GameObjects: 3
1. Dungeon
1 1 1 1 1 1 1 1 1 1 1 1 1 1 1 1
1 0 0 0 0 0 0 0 0 0 0 0 0 1 1 1
1 0 0 0 0 0 0 0 0 0 0 0 0 1 1 1
1 0 0 0 0 0 0 0 0 0 0 0 0 1 1 1
1 0 0 0 0 0 0 0 8 0 0 0 0 1 1 1
1 0 0 1 1 0 0 1 1 0 0 0 0 1 1 1
1 0 0 1 1 0 0 1 1 0 0 0 0 1 1 1
1 0 0 0 0 0 0 0 0 0 0 0 0 1 1 1
1 0 0 0 0 0 1 1 1 1 0 0 9 1 1 1
1 1 1 1 1 1 1 1 1 1 1 1 1 1 1 1

2. SawBlade
NUMBERBLADES 3
POSITION 1 1
POSITION 4 3
POSITION 5 3

3. Star
NUMBERSTARS 3
POSITION 5 4
POSITION 0 3
POSITION 4 2