#Objects: 5
1. DungeonBackground
RENDERER DungeonBackground
POSITION 0 0 -2
ROTATION 0 0 0
SCALE 1 1 1

2. Dungeon
1 1 1 1 1 1 1 1 1 1 1 1 1 1 1 1
1 0 0 0 0 0 0 0 0 0 0 0 0 0 0 1
1 9 0 0 0 0 0 0 0 0 0 0 0 0 0 1
1 1 1 0 0 0 0 0 0 0 0 0 0 0 0 1
1 1 1 0 0 1 1 1 1 1 1 1 1 1 0 1
1 1 1 0 0 1 1 1 1 1 1 1 1 1 0 1
1 1 1 8 0 0 0 0 0 1 1 0 1 1 0 1
1 1 1 1 1 1 1 1 0 1 1 0 1 1 0 1
1 1 1 1 1 1 1 1 0 0 0 0 0 0 0 1
1 1 1 1 1 1 1 1 1 1 1 1 1 1 1 1

3. SawBlade
NUMBERBLADES 2
POSITION 2 3
POSITION 3 3

4. Guard
NUMBERGUARDS 1
POSITIONSTART 6 5
POSITIONEND 8 5

5. Star
NUMBERSTARS 3
POSITION 6 5
POSITION 2 5
POSITION 10 2