#DungeonBackground
RENDERER DungeonBackground
POSITION 0 0 -2
ROTATION 0 0 0
SCALE 1 1 1

#GameObjects: 4
1. Dungeon
1 1 1 1 1 1 1 1 1 1 1 1 1 1 1 1
1 0 0 0 8 1 1 0 0 0 0 0 0 0 0 2
1 0 0 0 0 1 1 0 1 1 0 0 0 0 0 2
1 0 0 1 1 1 1 0 1 1 0 0 0 0 0 2
1 0 0 1 1 1 1 0 0 0 0 0 0 0 0 2
1 0 0 0 0 0 0 0 1 1 1 1 0 1 1 1
1 0 0 0 0 0 0 0 1 1 1 1 0 1 1 1
1 1 1 1 1 1 1 0 0 0 0 0 0 1 1 1
1 1 1 1 1 1 1 0 0 0 0 0 9 1 1 1
1 1 1 1 1 1 1 1 1 1 1 1 1 1 1 1

2. SawBlade
NUMBERBLADES 3
POSITION 9 5
POSITION 4 2
POSITION 2 3

3. Guard
NUMBERGUARDS 1
POSITIONSTART 6 0
POSITIONEND 10 0

4. Star
NUMBERSTARS 3
POSITION 11 2
POSITION 6 6
POSITION 0 5
