#DungeonBackground
RENDERER BackGround5
POSITION 0 0 -2
ROTATION 0 0 0
SCALE 1 1 1

#GameObjects: 4
1. Dungeon
1 1 1 1 1 1 1 1 1 1 1 1 1 1 1 1
1 0 0 0 0 0 0 0 0 0 0 0 0 0 0 1
1 0 0 0 0 0 0 0 0 0 0 0 0 0 0 1
1 0 0 0 0 0 0 1 1 0 0 0 0 0 0 1
1 8 0 0 0 0 0 1 1 0 0 0 0 0 0 1
1 0 0 1 1 1 1 1 1 1 1 1 1 0 0 1
1 0 0 1 1 1 1 1 1 1 1 1 1 0 0 1
1 0 0 0 0 0 0 0 0 0 0 0 0 0 0 1
1 0 0 0 0 0 0 0 0 0 0 0 0 9 0 1
1 1 1 1 1 1 1 1 1 1 1 1 1 1 1 1

2. SawBlade
NUMBERBLADES 2
POSITION 10 1
POSITION 3 1

3. Guard
NUMBERGUARDS 1
POSITIONSTART 2 0
POSITIONEND 11 0

4. Star
NUMBERSTARS 3
POSITION 7 1
POSITION 0 1
POSITION 10 5