#Objects: 2
1. DungeonBackground
RENDERER DungeonBackground
POSITION 0 0 -2
ROTATION 0 0 0
SCALE 1 1 1

2. Dungeon
1 1 1 1 1 1 1 1 1 1 1 1 1 1 1 1
1 0 0 0 0 0 0 0 0 0 0 0 0 0 0 1
1 8 0 0 0 0 0 0 0 0 0 0 0 0 0 1
1 1 1 0 0 1 1 0 0 1 1 0 0 1 1 1
1 1 1 0 0 1 1 0 0 1 1 0 0 1 1 1
1 1 1 0 0 0 0 0 0 0 0 0 0 1 1 1
1 1 1 0 0 0 0 1 1 0 0 0 0 1 1 1
1 0 0 0 0 0 1 1 1 1 0 0 0 0 0 1
1 0 0 0 0 1 1 1 1 1 1 0 0 9 0 1
1 1 1 1 1 1 1 1 1 1 1 1 1 1 1 1