#Objects: 5
1. DungeonBackground
RENDERER DungeonBackground
POSITION 0 0 -2
ROTATION 0 0 0
SCALE 1 1 1

2. Dungeon
1 1 1 1 1 1 1 1 1 1 1 1 1 1 1 1
1 8 0 1 1 0 0 0 0 0 0 0 0 0 0 1
1 0 0 1 1 0 0 0 0 0 0 0 0 0 0 1
1 0 0 1 1 0 0 1 1 1 1 0 0 1 1 1
1 0 0 1 1 0 0 1 1 1 1 0 0 1 1 1
1 0 0 0 0 0 0 1 1 0 0 0 0 0 0 1
1 0 0 1 1 0 0 1 1 0 0 0 0 0 0 1
1 1 1 1 1 0 0 0 0 0 0 0 0 0 0 1
1 1 1 1 1 0 0 0 0 0 0 0 0 9 0 1
1 1 1 1 1 1 1 1 1 1 1 1 1 1 1 1

3. SawBlade
NUMBERBLADES 2
POSITION 8 6
POSITION 4 0

4. Guard
NUMBERGUARDS 1
POSITIONSTART 9 0
POSITIONEND 10 0

5. Star
NUMBERSTARS 3
POSITION 10 1
POSITION 8 7
POSITION 1 6