#DungeonBackground
RENDERER BackGround4
POSITION 0 0 -2
ROTATION 0 0 0
SCALE 1 1 1

#GameObjects: 4
1. Dungeon
1 1 1 1 1 1 1 1 1 1 1 1 1 1 1 1
1 0 0 0 0 0 0 0 0 0 0 0 0 0 0 1
1 0 0 0 0 0 0 0 0 0 0 0 0 0 0 1
1 1 1 1 1 0 0 1 1 0 0 1 1 0 9 1
1 1 1 1 1 0 0 1 1 0 0 1 1 0 0 1
1 0 0 0 0 0 0 1 1 0 0 1 1 0 0 1
1 0 0 0 0 0 0 1 1 0 0 1 1 0 0 1
1 8 0 0 0 0 0 1 1 0 0 0 0 0 0 1
1 0 0 0 0 0 0 1 1 0 0 0 0 0 0 1
1 1 1 1 1 1 1 1 1 1 1 1 1 1 1 1

2. Guard
NUMBERGUARDS 1
POSITIONSTART 8 0
POSITIONEND 13 0

3. Spinner
NUMBERSPINNERS 1
POSITION 3 1
POSITIONCENTER 4 2

4. Star
NUMBERSTARS 3
POSITION 8 2
POSITION 1 6
POSITION 3 1
