#DungeonBackground
RENDERER BackGround3
POSITION 0 0 -2
ROTATION 0 0 0
SCALE 1 1 1

#GameObjects: 4
1. Dungeon
1 1 1 1 1 1 1 1 1 1 1 1 1 1 1 1 
1 1 1 1 1 1 0 0 0 0 0 0 0 0 0 1   
1 1 1 1 1 1 0 0 0 0 0 0 0 0 0 1   
1 0 0 0 1 1 0 0 1 1 0 1 1 0 0 1   
1 0 0 8 1 1 0 0 1 1 0 1 1 0 0 1   
1 0 1 1 1 1 0 0 1 1 0 1 1 0 0 1   
1 0 1 1 1 1 0 0 0 0 0 1 1 0 0 1
1 0 0 0 0 0 0 0 0 0 0 1 1 0 9 1	
1 1 1 1 1 1 1 1 1 1 1 1 1 1 1 1
1 1 1 1 1 1 1 1 1 1 1 1 1 1 1 1

2. SawBlade
NUMBERBLADES 3
POSITION 5 3
POSITION 6 3
POSITION 2 5

3. Spinner
NUMBERSPINNERS 1
POSITION 7 2
POSITIONCENTER 8 1

4. Star
NUMBERSTARS 3
POSITION 5 4
POSITION 9 2
POSITION 2 1
