#DungeonBackground
RENDERER DungeonBackground
POSITION 0 0 -2
ROTATION 0 0 0
SCALE 1 1 1

#GameObjects: 4
1. Dungeon
1 1 1 1 1 1 1 1 1 1 1 1 1 1 1 1
1 0 0 0 0 0 0 0 0 0 0 0 0 0 0 1
1 0 0 0 0 0 0 0 0 0 0 0 0 0 0 1
1 0 0 0 0 0 0 0 0 0 0 0 0 0 0 1
1 0 0 0 0 0 0 0 0 0 0 0 0 0 0 1
1 1 1 0 0 1 1 1 1 0 0 1 1 0 0 1
1 1 1 0 0 1 1 1 1 0 0 1 1 0 0 1
1 1 1 0 0 1 1 1 1 0 0 0 0 0 0 1
1 1 1 8 0 1 1 1 1 0 0 0 0 9 0 1
1 1 1 1 1 1 1 1 1 1 1 1 1 1 1 1

2. SawBlade
NUMBERBLADES 2
POSITION 9 0
POSITION 3 0

3. Guard
NUMBERGUARDS 1
POSITIONSTART 0 4
POSITIONEND 1 4

4. Star
NUMBERSTARS 3
POSITION 12 2
POSITION 9 4
POSITION 2 1