#DungeonBackground
RENDERER DungeonBackground
POSITION 0 0 -2
ROTATION 0 0 0
SCALE 1 1 1

#GameObjects: 4
1. Dungeon
1 1 1 1 1 1 1 1 1 1 1 1 1 1 1 1
1 0 0 0 0 0 0 0 0 0 0 0 0 0 0 1
1 0 0 0 0 0 0 0 0 0 0 0 0 0 0 1
1 1 1 1 1 0 0 0 0 0 0 1 1 1 1 1
1 1 1 1 1 0 0 0 0 0 0 1 1 1 1 1
1 1 1 1 1 0 0 1 1 0 0 1 1 1 1 1
1 1 1 1 1 0 0 1 1 0 0 1 1 1 1 1
1 0 0 0 0 0 0 1 1 0 0 0 0 0 0 1
1 0 9 0 0 0 0 1 1 0 0 0 0 8 0 1
1 1 1 1 1 1 1 1 1 1 1 1 1 1 1 1


2. SawBlade
NUMBERBLADES 2
POSITION 3 0
POSITION 10 0

3. Chaser
NUMBERCHASERS 1
POSITION 13 7

4. Star
NUMBERSTARS 3
POSITION 5 1
POSITION 7 4
POSITION 10 1