#Objects: 5
1. DungeonBackground
RENDERER DungeonBackground
POSITION 0 0 -2
ROTATION 0 0 0
SCALE 1 1 1

2. Dungeon
1 1 1 1 1 1 1 1 1 1 1 1 1 1 1 1
1 8 0 1 1 0 0 0 0 1 1 0 0 0 0 1
1 0 0 1 1 0 0 0 0 1 1 0 0 0 9 1
1 0 0 1 1 0 0 0 0 0 0 0 0 1 1 1
1 0 0 1 1 0 0 0 0 0 0 0 0 1 1 1
1 0 0 0 0 0 0 1 1 0 0 1 1 1 1 1
1 0 0 0 0 0 0 1 1 0 0 1 1 1 1 1
1 1 1 1 1 0 0 1 1 0 0 0 0 1 1 1
1 1 1 1 1 0 0 1 1 0 0 0 0 1 1 1
1 1 1 1 1 1 1 1 1 1 1 1 1 1 1 1

3. SawBlade
NUMBERBLADES 3
POSITION 10 7
POSITION 8 1
POSITION 2 2

4. DynamicBlade
NUMBERDYNAMICBLADES 1
POSITIONSTART 4 1
POSITIONEND 4 6

5. Star
NUMBERSTARS 3
POSITION 12 7
POSITION 6 4
POSITION 0 5