#Objects: 2
1. DungeonBackground
RENDERER DungeonBackground
POSITION 0 0 -2
ROTATION 0 0 0
SCALE 1 1 1

2. Dungeon
1 1 1 1 1 1 1 1 1 1 1 1 1 1 1 1
1 8 0 1 1 0 0 0 0 1 1 0 0 0 0 1
1 0 0 1 1 0 0 0 0 1 1 0 0 0 0 1
1 0 0 1 1 0 0 0 0 0 0 0 0 1 1 1
1 0 0 0 0 0 0 0 0 0 0 0 0 1 1 1
1 0 0 0 0 0 0 1 1 0 0 1 1 1 1 1
1 0 0 1 1 0 0 1 1 0 0 1 1 1 1 1
1 1 1 1 1 0 0 1 1 0 0 0 0 1 1 1
1 1 1 1 1 0 0 1 1 0 0 0 0 1 1 1
1 1 1 1 1 1 1 1 1 1 1 1 1 1 1 1

3. SawBlade
NUMBERBLADES 3
POSITION 10 7
POSITION 8 1
POSITION 1 2

4. DynamicBlade
NUMBERDYNAMICBLADES 1
POSITIONSTART 5 5
POSITIONEND 5 8

5. Star
NUMBERSTARS 3
POSITION 2 2
POSITION 6 1
POSITION 10 2