#Objects: 6
1. DungeonBackground
RENDERER DungeonBackground
POSITION 0 0 -2
ROTATION 0 0 0
SCALE 1 1 1

2. Dungeon
1 1 1 1 1 1 1 1 1 1 1 1 1 1 1 1
1 0 0 0 0 0 0 0 0 0 0 0 0 0 0 1
1 0 0 0 0 0 0 0 0 0 0 0 0 0 0 1
1 0 0 0 0 0 0 0 0 0 0 0 0 0 0 1
1 0 0 0 0 0 0 0 0 7 0 0 0 0 0 1
1 1 1 0 0 0 0 0 0 1 1 0 0 1 1 1
1 1 1 5 0 0 6 5 0 1 1 0 0 1 1 1
1 0 0 0 0 1 1 0 0 0 0 0 5 1 1 1
1 3 0 0 0 1 1 0 0 6 0 0 6 1 1 1
1 1 1 1 1 1 1 1 1 1 1 1 1 1 1 1

3. SawBlade
NUMBERBLADES 1
POSITION 6 6

4. Guard
NUMBERGUARDS 1
POSITIONSTART 6 7
POSITIONEND 8 7

5. Spinner
NUMBERSPINNERS 1
POSITION 4 4
POSITIONCENTER 4 5

6. Chaser
NUMBERCHASERS 1
POSITION 8 6