#Objects: 2
1. DungeonBackground
RENDERER DungeonBackground
POSITION 0 0 -2
ROTATION 0 0 0
SCALE 1 1 1

2. Dungeon
1 1 1 1 1 1 1 1 1 1 1 1 1 1 1 1
1 0 0 0 0 0 0 0 0 0 0 0 0 0 8 1
1 0 0 0 0 0 0 0 0 0 0 0 0 0 0 1
1 0 0 0 0 0 0 0 0 0 0 0 0 0 0 1
1 0 0 0 0 0 0 0 0 7 0 0 0 0 0 1
1 1 1 0 0 0 0 0 0 1 1 0 0 1 1 1
1 1 1 5 0 0 6 5 0 1 1 0 0 1 1 1
1 0 0 0 0 1 1 0 0 0 0 0 5 1 1 1
1 3 0 0 0 1 1 0 0 6 0 0 6 1 1 1
1 1 1 1 1 1 1 1 1 1 1 1 1 1 1 1