#Objects: 2
1. DungeonBackground
RENDERER DungeonBackground
POSITION 0 0 -2
ROTATION 0 0 0
SCALE 1 1 1

2. Dungeon
1 1 1 1 1 1 1 1 1 1 1 1 1 1 1 1
1 0 0 5 5 5 0 0 0 0 0 0 0 0 0 1
1 0 0 0 0 1 6 0 0 0 0 0 3 0 0 1
1 0 0 1 1 1 1 1 1 1 1 1 1 1 1 1
1 0 0 0 0 0 0 0 0 0 0 0 0 0 0 1
1 0 0 0 0 0 0 0 0 5 5 0 0 0 0 1
1 0 0 0 0 0 6 0 0 1 0 0 0 0 0 1
1 1 1 1 1 1 1 1 1 1 1 1 1 0 0 1
1 0 7 0 0 0 0 0 0 0 0 0 0 0 0 1
1 1 1 1 1 1 1 1 1 1 1 1 1 1 1 1

3. Gate
POSITION 0 0

4. Star